YEAR,WARNER BROS,WALT DISNEY,20TH CENTURY FOX,PARAMOUNT PICTURES,SONY PICTURES,UNIVERSAL,TOTAL MAJOR 6,TOTAL OTHER STUDIOS
1995,27,22,11,12,20,17,109,27
1996,31,23,13,16,24,13,120,22
1997,31,22,12,16,22,11,114,22
1998,27,21,11,11,20,16,106,20
1999,27,20,15,13,22,16,113,19
2000,29,22,13,12,15,13,104,27
2001,30,16,16,14,17,10,103,25
2002,32,23,15,16,20,13,119,21
2003,28,19,13,14,19,13,106,23
2004,27,25,18,14,15,14,113,25
